111111111
1EP000001
1C0000011
111111111