111111111111111111
1EP000000000000001
1C00C0C0C0C0000011
111111111111111111